1,0,0,0,0,0,1,0,0,0,0,1,0,0,0,0,0,1
0,3,3,3,0,0,0,3,4,3,3,0,0,0,3,3,3,0
0,3,0,3,0,0,0,0,0,0,0,0,0,0,3,0,3,0
0,3,3,3,0,0,0,2,2,2,4,0,0,0,3,3,3,0
0,0,0,0,0,0,2,3,3,3,3,2,4,4,0,0,0,0
3,3,3,3,0,3,4,0,0,3,0,3,2,0,0,0,0,0
3,0,3,0,3,2,3,3,4,4,3,3,2,3,3,0,0,0
0,3,3,4,4,2,0,5,0,0,0,0,9,3,3,0,0,3
8,8,8,3,3,10,0,0,0,0,0,2,3,0,0,0,3,3
0,0,0,0,3,3,2,0,6,0,0,4,3,3,0,0,3,0