1,0,0,0,0,0,1,0,0,0,0,1,0,0,0,0,0,1
0,0,0,0,0,0,0,0,0,0,0,0,0,3,3,3,4,0
3,3,0,3,3,0,0,0,0,0,3,3,0,0,0,0,3,3
0,0,0,3,0,0,0,0,0,0,0,3,7,7,7,7,7,0
3,3,0,0,0,0,3,3,4,0,0,3,3,3,3,9,0,0
0,10,9,0,0,3,3,0,3,3,3,0,0,0,0,0,0,0
8,4,0,0,3,3,0,0,0,3,0,0,0,0,0,3,3,3
3,3,3,7,4,0,3,0,0,0,0,0,0,0,3,0,0,3
0,0,3,10,0,0,3,0,0,0,0,0,0,3,3,0,0,3
0,0,3,10,0,0,0,5,6,4,0,0,0,3,3,0,0,0