1,0,0,3,4,0,1,0,3,3,0,1,0,4,3,0,0,1
0,0,0,4,4,0,0,0,0,0,0,0,0,4,4,0,0,0
0,0,0,10,3,3,0,0,0,0,0,0,3,3,9,2,2,3
3,4,4,2,2,4,0,3,3,0,0,0,0,0,0,3,0,0
3,4,4,3,3,4,0,0,0,0,0,0,3,3,0,0,0,4
0,0,0,0,0,4,3,0,3,0,0,0,3,3,4,4,4,0
0,4,4,4,0,4,4,4,8,8,8,4,4,4,4,4,0,0
3,3,3,4,0,0,0,0,0,0,0,0,0,0,0,3,3,3
3,3,3,4,3,3,3,4,4,4,0,0,4,4,4,0,0,3
3,3,5,9,0,0,0,0,6,3,3,3,3,4,0,0,0,3